#########################
#  $ $ $ $ $ $ $ $ $ $  #
#                       #
#                       #
#                       #
#                       #
#                       #
#                       #
#                       #
##########-----##########